11111111111111111111
1S000000000000000001
11111110111111011101
111111101111110111F1
11100000000111011101
11101111110011111101
11101111111000000001
11100000111011111111
11111110111011111111
11111000111000111111
11111011111101111111
11110011111100000111
11110111111111011111
10110111111111011111
10010111111111011111
10000111111011011111
11110100011011011111
11110101111011111111
11000000000000000011
11111111111111111111