S1111111
01011111
00001110
11000011
10011011
11011FF1
10000FF1
10111111